OTTDTTOTTTTTOTTTOTTO
I     O2    O   O  I
I     O            I
I       OTTTTO OTTTO
I     O OTTTTO OTTTO
I   C I IE        CI
OTTTTTO OTTTTO OTTTI
I 1   O O C  O O  CI
I     O O    O O   I
I       	   I
IP    OOO    3     I
OTTTTOTTTTTTTTTTTTTO