OTTTTTDO    OOTTTTTO
IP     OO  OO    C4I
I TTTO  OOOO  OTTT I
I    3O  OO  O 2   I
OO  O  O    O  O  OO
 OO  O  O  O  O  OO
  OO  O  OO  O	OO  
 OO  O   OO   O  OO 
OO  O  OC 1 O  O  OO
I  OTTO  OO  O OO  D
IE      OOOO C	   I
OTTTTTTOO  OOTTTTTTO


