OTTTTDTTTTTTTTTTTTTO
I	    C  I1C I
OTTO  OTTTTTTTTO O I
IE		   I
OTTTTTTTTTTTTTTO  2I
I   		   I
I OTTT O  O O TTTT I
I ITT   OO    I  I I
I I     OO  I ITTI I
I OTTT O  O I I  I I
I		  PI
OTTTTTTTTTTTTTTTTTTO