OTTOTTOTTTTTTTTTTTTO
I 2I  I     1  O OEI
I  I     OOO  O O CI
OO O OO OOOOTTTTTTTO
IO3   I 	  PI
O O O OT TOTOTOT OTO
I O  4I	O I I I O  I
I O   I I  I I  I  I
OO OOOOTOTOTOTOTOTTO
I  O C O C O C O   I
I    O C O C O C   D
OTTTTTTTTTTTTTTTTTTO