   OTTTTOTTTTTTTTTTO
   IP   I  2   I C I
OTTO  OTOTTTTTTO O I
IE  C  		   I
OTTTTTTTTTTTTTTO C4I
I   		   I
I OTTT O  O O TTTT I
I ITT   OO    I3 I I
I IC    OO  I ITTI I
I OTTT O  O I I CI1D
I      		   I
OTTTTTTTTTTTTTTTTTTO